01010101010101010101010101010101010101010101010101010101010101010101010101010101010101010101010101010101010101
01010101010101010101010101010101010101010101010101010101010101010101010101010101010101010101010101010101010101
01010E01000000000000000000000001000000000000000000010000000000000000000000000000000000000000000000010000000101
01010001000101010101010101010001000101010101000100010101010100010101010101010101010101010101010100010001000101
01010001000000010001000000000001000100000000000100000000000000010000000100000000000000000001000100010001000101
01010001010100010001000101010101010100010101010101010101010101010001010100010101010100010001000100010001000101
01010000000000010001000000000000000100010000000000010000000100000000000000010000000000010000000100010001000101
01010101010101010001010101010101000100010001010100010001000101010001010101010001010101010101000100010101000101
01010000000000000001000000000000000100000000000100000001000000010000000100000001000000010000000100000001000101
01010001010101010101000101010101010101010101010101010101010100010101010100010101000101010001010101010001000101
01010000000000000000000100000001000000000000000100000000000000010000000000010000000100000001000000000001000101
01010001010101010101010100010001000100010101000100010101010101010001010101010001010100010101000101010101000101
01010000000000000001000000010001000100010000000100010000000100000001000000000001000000000001000100000001000101
01010101010101010001010100010001000100010001010100010001010100010001010101010001000101010101000100010001000101
01010001000000010000000000010001000100010000000000010001000000010001000000010000000100010000000100010000000101
01010001000100010101010101010001010100010101010101010001000101010001000100010001010100010001010100010101000101
01010000000100000000000000010000000100010000000000000000000100010000000100010000000000010001000000010001000101
01010001010101010101000101010101000100010001010101010101010100010101010100010101010100010001000101010001000101
01010001000000000001000100000001000100010000000000000000000100000001000000010000000100010001000000010001000101
01010001000101010001000100010001000100010101010101010101000101010001000101010001000101010001010100010001000101
010100000001000000010000000100000000000100000000000000000000000000010000000000010000000000000000000100000S0101
01010101010101010101010101010101010101010101010101010101010101010101010101010101010101010101010101010101010101
01010101010101010101010101010101010101010101010101010101010101010101010101010101010101010101010101010101010101

